NO ./pics/fool.png
SO ./pics/fool.png
WE ./pics/fool.png
EA ./pics/fool.png

F 220,100,0
C 225,30,0


1111111111111111111111111
1000000000110000000000001
1011000001110000011000001
1001000000000000000000011
1000000000110000011101111111111
111101111111110111000000000011111
11 1111101111111110111010100100011
111110000011010101110000001000111
1000001100000000000000001000111
10001000000000000100010010001
11000001110101011111011110E0111
11110111 1110101 100000000001
11111111 1111111 111111111111


