NO ./path_to_the_north_texture
   		SO ./path_to_the_south_texture
WE ./path_to_the_west_texture
EA ./path_to_the_east_texture

F 220,100,0
C 225,30,0


1111111111111111111111111
1000000000110000000000001
1011000001110000011000001
1001000000000000000000011
100000000011000001110111111111111
111101111111110111000000000011111
11 11111011111111101110101001000111
111110000011010101110000001000111
1000001100000000000000001000111
10000000000000000100010010001
11000001110101011111011110E0111
11110111 1110101 100000000001
11111111 1111111 111111111111


