NO pics/hierophante.xpm

SO pics/world.xpm

WE pics/chariot.xpm

EA pics/hermit.xpm

F 110,110,110
C 0,0,255

1111111111111111111111111
1000000000110000000000001
1011000001110000011000001
1001000000000000000000011
10000000001100000111011111111111
111101111111110111000000000011111
11 1111101111111110111010100100011
111110000011010101110000001000111
1000001100000000000000001000111
10001000000000000100010010001
11000001110101011111011110N011
11110111 1110101 100000000001
11111111 1111111 111111111111




